**********
* *     **
* * **5  *
*7*  **  *
*     *  *
***6 *** *
* ** * ***
*      *4*
* * *    *
***** ****
